05 x 05
*****
* H *
*   *
*   *
**O**